#!/bin/bash

printf "\n\n"
echo "The clown you saw on the wall is standing right in front of you and approching you fast"

read -p "Do you want to fight the clown? [y/n]: " fight
if [[ $fight = "Y" || $fight = "y" ]]
	sleep 1
	then
	cat <<EOF
┼┼┼┼┼┼┼┼┼┼┼┼┼┼┼┼┼┼┼┼┼┼┼┼┼┼┼┼┼┼┼┼┼┼┼┼
███▀▀▀██┼███▀▀▀███┼███▀█▄█▀███┼██▀▀▀
██┼┼┼┼██┼██┼┼┼┼┼██┼██┼┼┼█┼┼┼██┼██┼┼┼
██┼┼┼▄▄▄┼██▄▄▄▄▄██┼██┼┼┼▀┼┼┼██┼██▀▀▀
██┼┼┼┼██┼██┼┼┼┼┼██┼██┼┼┼┼┼┼┼██┼██┼┼┼
███▄▄▄██┼██┼┼┼┼┼██┼██┼┼┼┼┼┼┼██┼██▄▄▄
┼┼┼┼┼┼┼┼┼┼┼┼┼┼┼┼┼┼┼┼┼┼┼┼┼┼┼┼┼┼┼┼┼┼┼┼
███▀▀▀███┼▀███┼┼██▀┼██▀▀▀┼██▀▀▀▀██▄┼
██┼┼┼┼┼██┼┼┼██┼┼██┼┼██┼┼┼┼██┼┼┼┼┼██┼
██┼┼┼┼┼██┼┼┼██┼┼██┼┼██▀▀▀┼██▄▄▄▄▄▀▀┼
██┼┼┼┼┼██┼┼┼██┼┼█▀┼┼██┼┼┼┼██┼┼┼┼┼██┼
███▄▄▄███┼┼┼─▀█▀┼┼─┼██▄▄▄┼██┼┼┼┼┼██▄
┼┼┼┼┼┼┼┼┼┼┼┼┼┼┼┼┼┼┼┼┼┼┼┼┼┼┼┼┼┼┼┼┼┼┼┼
┼┼┼┼┼┼┼┼██┼┼┼┼┼┼┼┼┼┼┼┼┼┼┼██┼┼┼┼┼┼┼┼┼
┼┼┼┼┼┼████▄┼┼┼▄▄▄▄▄▄▄┼┼┼▄████┼┼┼┼┼┼┼
┼┼┼┼┼┼┼┼┼▀▀█▄█████████▄█▀▀┼┼┼┼┼┼┼┼┼┼
┼┼┼┼┼┼┼┼┼┼┼█████████████┼┼┼┼┼┼┼┼┼┼┼┼
┼┼┼┼┼┼┼┼┼┼┼██▀▀▀███▀▀▀██┼┼┼┼┼┼┼┼┼┼┼┼
┼┼┼┼┼┼┼┼┼┼┼██┼┼┼███┼┼┼██┼┼┼┼┼┼┼┼┼┼┼┼
┼┼┼┼┼┼┼┼┼┼┼█████▀▄▀█████┼┼┼┼┼┼┼┼┼┼┼┼
┼┼┼┼┼┼┼┼┼┼┼┼███████████┼┼┼┼┼┼┼┼┼┼┼┼┼
┼┼┼┼┼┼┼┼▄▄▄██┼┼█▀█▀█┼┼██▄▄▄┼┼┼┼┼┼┼┼┼
┼┼┼┼┼┼┼┼▀▀██┼┼┼┼┼┼┼┼┼┼┼██▀▀┼┼┼┼┼┼┼┼┼
┼┼┼┼┼┼┼┼┼┼▀▀┼┼┼┼┼┼┼┼┼┼┼▀▀┼┼┼┼┼┼┼┼┼┼┼
┼┼┼┼┼┼┼┼┼┼┼┼┼┼┼┼┼┼┼┼┼┼┼┼┼┼┼┼┼┼┼┼┼┼┼┼

EOF

printf "Unfortunately, the clown refused to let you escape.\n"

else [[ $fight = "N" || $fight = "n" ]]
	sleep 1

	cat <<EOF

┼┼┼┼┼┼┼┼┼┼┼┼┼┼┼┼┼┼┼┼┼┼┼┼┼┼┼┼┼┼┼┼┼┼┼┼
███▀▀▀██┼███▀▀▀███┼███▀█▄█▀███┼██▀▀▀
██┼┼┼┼██┼██┼┼┼┼┼██┼██┼┼┼█┼┼┼██┼██┼┼┼
██┼┼┼▄▄▄┼██▄▄▄▄▄██┼██┼┼┼▀┼┼┼██┼██▀▀▀
██┼┼┼┼██┼██┼┼┼┼┼██┼██┼┼┼┼┼┼┼██┼██┼┼┼
███▄▄▄██┼██┼┼┼┼┼██┼██┼┼┼┼┼┼┼██┼██▄▄▄
┼┼┼┼┼┼┼┼┼┼┼┼┼┼┼┼┼┼┼┼┼┼┼┼┼┼┼┼┼┼┼┼┼┼┼┼
███▀▀▀███┼▀███┼┼██▀┼██▀▀▀┼██▀▀▀▀██▄┼
██┼┼┼┼┼██┼┼┼██┼┼██┼┼██┼┼┼┼██┼┼┼┼┼██┼
██┼┼┼┼┼██┼┼┼██┼┼██┼┼██▀▀▀┼██▄▄▄▄▄▀▀┼
██┼┼┼┼┼██┼┼┼██┼┼█▀┼┼██┼┼┼┼██┼┼┼┼┼██┼
███▄▄▄███┼┼┼─▀█▀┼┼─┼██▄▄▄┼██┼┼┼┼┼██▄
┼┼┼┼┼┼┼┼┼┼┼┼┼┼┼┼┼┼┼┼┼┼┼┼┼┼┼┼┼┼┼┼┼┼┼┼
┼┼┼┼┼┼┼┼██┼┼┼┼┼┼┼┼┼┼┼┼┼┼┼██┼┼┼┼┼┼┼┼┼
┼┼┼┼┼┼████▄┼┼┼▄▄▄▄▄▄▄┼┼┼▄████┼┼┼┼┼┼┼
┼┼┼┼┼┼┼┼┼▀▀█▄█████████▄█▀▀┼┼┼┼┼┼┼┼┼┼
┼┼┼┼┼┼┼┼┼┼┼█████████████┼┼┼┼┼┼┼┼┼┼┼┼
┼┼┼┼┼┼┼┼┼┼┼██▀▀▀███▀▀▀██┼┼┼┼┼┼┼┼┼┼┼┼
┼┼┼┼┼┼┼┼┼┼┼██┼┼┼███┼┼┼██┼┼┼┼┼┼┼┼┼┼┼┼
┼┼┼┼┼┼┼┼┼┼┼█████▀▄▀█████┼┼┼┼┼┼┼┼┼┼┼┼
┼┼┼┼┼┼┼┼┼┼┼┼███████████┼┼┼┼┼┼┼┼┼┼┼┼┼
┼┼┼┼┼┼┼┼▄▄▄██┼┼█▀█▀█┼┼██▄▄▄┼┼┼┼┼┼┼┼┼
┼┼┼┼┼┼┼┼▀▀██┼┼┼┼┼┼┼┼┼┼┼██▀▀┼┼┼┼┼┼┼┼┼
┼┼┼┼┼┼┼┼┼┼▀▀┼┼┼┼┼┼┼┼┼┼┼▀▀┼┼┼┼┼┼┼┼┼┼┼
┼┼┼┼┼┼┼┼┼┼┼┼┼┼┼┼┼┼┼┼┼┼┼┼┼┼┼┼┼┼┼┼┼┼┼┼

EOF
fi
